make up: constituir
seat: asiento, puesto
vessel: recipiente, vaso
teem: pulular (Abundar o bullir en un paraje personas o cosas)
tiny: minúsculo
amok: sin control
give up: abandonar
remnant: resto
ceaseless: incesante
medicine: medicina
throughout: completamente, a lo largo y ancho
rather than: en lugar de
fought - fight: luchar
protracted: prolongado 
meticulous: meticuloso (Que cuida mucho los detalles)
indeed: en efecto
comprise: comprender
spite: fastidiar, rencor
in spite of: a pesar de
handicap: minusvalia
subject: tema
stand: perdurar
tribute: tributo, elogio
devise: idear
biologist: biólogico
As will be: como será
apparent: aparente
reductionist: reduccionista
machinery: maquinaria
degree: grado
loss: perdida
underlying: subyacente
remarkable: notable
bend: doblar
Spectacles: gafas
lens: lente
handful: puñado
handmade: hecho a mano
uncover: descubrir
awarded: concedido
curator: comisario
foremost: los más destacado
attempt: intentar
stopper: tapon
Pen‐knife: navaja
sharpen: afilar
as keen as: tan entusiasta como 
Razor: navaja
In actual fact: en realidad
tissue: tejido
spend: gastar
spare: chispa
spare time: tiempo libre
grind: moler
along: a lo largo
rambling: divagacion
discourse: discurso
daily: diario
drop: gota
pond: estanque
amazement: asombro
teem: pulular
soak: remojar
scrape: raspar
unseen: no se ve
dispatched: enviado
worldwide: en todo el mundo
widespread: extendido
lawyer: abogado
despite: a pesar de
arose - arise: sugir
comprehensive: completo
tenets: principios
